{
    "textures": ["Projekt_Tiles_2","Projekt_Tiles"],
    "height": 10,
    "width": 10,
    "groundData": [
        1,2,3,4,1,2,3,4,1,2,
        1,2,3,4,1,2,3,4,1,2,
        1,2,3,4,1,2,3,4,1,2,
        1,2,3,4,1,2,3,4,1,2,
        1,2,3,4,1,2,3,4,1,2,
        1,2,3,4,1,2,3,4,1,2,
        1,2,3,4,1,2,3,4,1,2,
        1,2,3,4,1,2,3,4,1,2,
        1,2,3,4,1,2,3,4,1,2,
        1,2,3,4,1,2,3,4,1,2
    ],
    "objectTiles": [
        2,3,4,5,6,
        2,3,4,5,6,
        2,3,4,5,6
    ],
    "blockedTiles": [
        0,0,0,0,0,0,0,0,0,0,
        0,0,0,1,0,0,0,0,0,0,
        0,0,0,0,0,0,0,0,0,0,
        0,0,0,0,0,0,0,0,0,0,
        0,0,0,0,0,0,0,0,0,0,
        0,0,0,0,0,0,0,0,0,0,
        0,0,0,0,0,0,0,0,0,0,
        0,0,0,0,0,0,0,0,0,0,
        0,0,0,0,0,0,0,0,0,0,
        0,0,0,0,0,0,0,0,0,0
    ]
}